111111111111111111
1000C0000000000011
11000000E000010011
111111111101100011
10000C000000000111
101111111100101111
10C00C00000P000E11
111111111111111111